9,9,9,9,9,9,9,9,9,9,9,9,9,9,9,9,9
9,21,1,0,12,12,12,0,11,11,11,0,0,1,0,4,9
9,0,9,0,9,12,9,0,9,11,9,0,9,0,9,1,9
9,0,0,8,0,0,0,0,0,0,0,0,0,1,0,0,9
9,13,9,0,9,0,9,1,9,1,9,1,9,0,9,0,9
9,13,13,0,0,0,1,0,0,0,1,0,0,3,0,1,9
9,13,9,0,9,1,9,0,9,0,9,0,9,0,9,0,9
9,0,0,0,1,0,0,2,0,0,0,1,0,1,0,2,9
9,14,9,0,9,0,9,0,9,0,9,0,9,0,9,0,9
9,14,14,0,0,1,0,1,0,0,0,1,0,0,0,1,9
9,14,9,0,9,0,9,0,9,0,9,0,9,0,9,0,9
9,0,0,0,0,1,0,5,0,1,0,0,0,4,0,0,9
9,9,9,9,9,9,9,9,9,9,9,9,9,9,9,9,9
